###############
@        #    #
##### # ## #  #
###   #    ####
#    # # ### ##
#### ##    #   
# ## #  ##   # 
# #   #  ### # 
#  ##  #    #  
###  # ### ## #
#  # # # #    #
## #     ### ##
#    #####   ##
# # #      #  .
###############
