@ #   ##       
#   #    # ### 
   ##### #     
 ###   # ######
   # #   #     
## # ##### ### 
 ###       #   
    ### #### ##
 ##     #    # 
 #  ###   ##   
 # #        ###
##    # ###  # 
    # # #    # 
###   # ####   
#   ##  #     .
